111111
1P0101
100011
1E0001
111111
