111111
1C0101
100011
1P00C1
111111
