111111
1C0101
100011
1E00C1
111111
