1111111
1P0C001
1001001
1E00C011
1111111
