111111
1P0101
100P11
1E00C1
111111
