111111
1C00E1
100P11
1E00C1
111111
