111111
1P01E1
10C011
1000C1
111111
