11111111111111111111
1P0000000000000000E1
10010001000111110001
1001C001000000010001
10010001000000010001
10011111000111110001
10000001000100000001
100C0001000100000001
10000001000111110001
1C00000000C0000000C1
11111111111111111111
