11111111111111111111
1P0000000000000000E1
10100010000111110001
1010C010000000010001
10100010000000010001
10111110000111110001
10000010000100000001
100C0010000100000001
10000010000111110001
1C00000000C0000000C1
11111111111111111111
