1111111111111
1P001000000E1
1010111011101
1000100000001
1110111110101
1C000C0010C01
1011101110101
1C000000000C1
1111111111111
