11111111111111111111111111
1E0000000000000C0000000001
10100101000001000000010101
10100100101001000000010101
1P0000000C00000000000000C1
11111111110111111111111111
